2,3,3,3,4,5,6,7,3,8
12,13,13,13,14,15,16,17,13,18
22,23,24,25,26,54,53,27,37,38
22,33,34,35,36,53,54,37,37,38
22,43,44,45,53,53,54,37,37,38
22,54,53,53,53,54,54,37,37,38
32,54,54,54,54,54,54,37,37,38
42,54,54,54,54,54,54,37,37,38
52,54,54,54,54,54,54,46,47,48
62,63,63,63,63,64,65,66,67,29
